width = 20 
height = 20 
data = [
    1, 1, 1, 1, 1, 1, 1, 1, 1, 1, 1, 1, 1, 1, 1, 1, 1, 1, 1, 1,
    1, 0, 0, 0, 0, 0, 0, 0, 0, 1, 1, 0, 0, 0, 0, 0, 0, 0, 0, 1,
    1, 0, 4, 4, 0, 0, 0, 0, 0, 2, 1, 0, 3, 3, 0, 0, 0, 0, 0, 1,
    1, 0, 3, 0, 0, 0, 0, 0, 0, 3, 1, 0, 3, 0, 0, 0, 0, 0, 0, 1,
    1, 0, 3, 0, 0, 0, 0, 0, 0, 4, 1, 0, 3, 0, 0, 0, 0, 0, 0, 1,
    1, 0, 0, 0, 0, 0, 0, 0, 0, 5, 1, 0, 0, 0, 0, 0, 0, 0, 0, 1,
    1, 0, 0, 0, 0, 0, 2, 2, 0, 6, 1, 0, 0, 0, 0, 0, 2, 2, 0, 1,
    9, 0, 0, 0, 0, 0, 2, 2, 0, 3, 3, 0, 0, 0, 0, 0, 2, 2, 0, 1,
    1, 0, 0, 0, 0, 0, 0, 0, 0, 0, 0, 0, 0, 0, 0, 0, 0, 0, 0, 1,
    1, 0, 4, 1, 4, 0, 1, 1, 0, 0, 0, 0, 1, 1, 1, 1, 1, 1, 1, 1,
    1, 0, 1, 1, 1, 1, 1, 1, 0, 0, 0, 0, 1, 1, 1, 1, 1, 1, 1, 1,
    1, 0, 0, 0, 0, 0, 0, 0, 0, 0, 0, 0, 0, 0, 0, 0, 0, 0, 0, 1,
    1, 0, 6, 6, 0, 0, 0, 0, 0, 3, 3, 0, 3, 3, 0, 0, 0, 0, 0, 1,
    1, 0, 1, 0, 0, 0, 0, 0, 0, 1, 1, 0, 3, 0, 0, 0, 0, 0, 0, 1,
    1, 0, 6, 0, 0, 0, 0, 0, 0, 1, 1, 0, 3, 0, 0, 0, 0, 0, 0, 1,
    1, 0, 0, 0, 0, 0, 0, 0, 0, 1, 1, 0, 0, 0, 0, 0, 0, 0, 0, 1,
    1, 0, 0, 0, 0, 0, 2, 2, 0, 1, 1, 0, 0, 0, 0, 0, 2, 2, 0, 1,
    9, 0, 0, 0, 0, 0, 2, 2, 0, 1, 9, 0, 0, 0, 0, 0, 2, 2, 0, 1,
    1, 0, 0, 0, 0, 0, 0, 0, 0, 1, 1, 0, 0, 0, 0, 0, 0, 0, 0, 1,
    1, 1, 1, 1, 1, 1, 1, 1, 1, 1  1, 1, 1, 1, 1, 1, 1, 1, 1, 1
]
