width = 20 
height = 20 
data = [
    1, 1, 1, 1, 1, 1, 1, 1, 1, 1, 1, 1, 1, 1, 1, 1, 1, 1, 1, 1,
    1, 0, 0, 0, 0, 0, 0, 0, 0, 6, 1, 0, 0, 0, 0, 0, 0, 0, 0, 1,
    1, 0, 0, 0, 0, 0, 0, 0, 0, 6, 1, 0, 7, 7, 0, 0, 0, 0, 0, 1,
    1, 0, 0, 0, 0, 0, 0, 0, 0, 3, 5, 0, 7, 0, 0, 0, 0, 0, 0, 1,
    1, 0, 0, 0, 3, 0, 0, 0, 0, 6, 5, 0, 7, 0, 0, 0, 0, 0, 0, 1,
    1, 0, 0, 0, 0, 0, 0, 0, 0, 6, 5, 0, 0, 0, 0, 0, 0, 0, 0, 1,
    1, 0, 0, 0, 0, 0, 0, 0, 0, 7, 5, 0, 0, 0, 0, 0, 2, 2, 0, 1,
    9, 0, 0, 0, 0, 0, 0, 0, 0, 0, 0, 0, 0, 0, 0, 0, 2, 2, 0, 1,
    1, 0, 0, 0, 0, 0, 0, 0, 0, 0, 0, 0, 0, 0, 0, 0, 0, 0, 0, 1,
    1, 0, 1, 0, 2, 0, 3, 0, 4, 0, 0, 0, 8, 8, 3, 8, 8, 1, 1, 1,
    1, 0, 1, 0, 2, 0, 3, 0, 4, 0, 0, 0, 8, 1, 1, 1, 1, 1, 1, 1,
    1, 0, 1, 0, 2, 0, 3, 0, 4, 0, 0, 0, 0, 0, 0, 0, 0, 0, 0, 1,
    1, 0, 0, 0, 0, 0, 0, 0, 0, 0, 0, 0, 3, 3, 0, 0, 0, 0, 0, 1,
    1, 0, 5, 0, 6, 0, 7, 0, 8, 0, 0, 0, 3, 0, 0, 0, 0, 0, 0, 1,
    1, 0, 5, 0, 6, 0, 7, 0, 8, 0, 0, 0, 3, 0, 0, 0, 0, 0, 0, 1,
    1, 0, 5, 0, 6, 0, 7, 0, 8, 0, 0, 0, 0, 0, 0, 0, 0, 0, 0, 1,
    1, 0, 0, 0, 0, 0, 0, 0, 0, 0, 0, 0, 0, 0, 0, 0, 2, 2, 0, 1,
    9, 0, 0, 0, 0, 0, 0, 0, 6, 3, 6, 0, 0, 0, 0, 0, 2, 2, 0, 1,
    1, 0, 0, 0, 0, 0, 0, 0, 0, 0, 0, 0, 0, 0, 0, 0, 0, 0, 0, 1,
    1, 1, 1, 1, 1, 1, 1, 1, 1, 1  1, 1, 1, 1, 1, 1, 1, 1, 1, 1
]
